@@@@@@BR@@@@@@DF@@@@AA@@@@DFED
......BF@@@@@@DFDDD1..D2DDDF..
..Mk....@@@@AA......Mb......Mj
......BF@@@@@@DF..DR......DFDD
@@@@@@BR@@@@@@DFD8DR......DRDF
BDBDBDB1BUBUMf@@DLDR..........
@@@@@@......@@@@DLDRD8AADRDLMp
@@@@..DFDFDFDFD3D5..DL@@@@D4BF
..AA..@@@@@@@@@@Mj..DL@@@@DRCU
oh
oc
LAST