Mc......BL@@@@DRMl..Lf@@@@DRD2
..@@@@@@BL@@@@DR......@@....DR
..@@Rc@@BFAAD3DU........Pf....
..@@@@@@BF..........Ta......Mh
..BUBUBUBF....Wa..@@..........
....Mp......................Mc
......................**Pf....
Mg....ELDR........D4@@**@@..Ta
....DLCRDR......MlDR@@..DDDDD8
ei
ah
baaa
level02.txt