@@@@D2......Mo..@@DR....@@..Mc
@@@@D6D4..........DR......DD..
@@@@AA..Mh......DDDFDL....DLWd
@@@@D7D1..................D2@@
@@@@D3........D7DDD8..Mo..D6DU
DUDUD5..DFDLAABRCLD3DU..Wc....
D8@@..........D6DUDLMe..DDD1..
DL..........Wg....D4....DUDU@@
D2DD..Me........@@DREUD2DD....
hf
kg
ccdk
LAST